12 18
##################
#                #
#                #
#     *          #
#      *     :   #
#                #
#     Ro         #
#                #
#                #
#%%%%%%%%%%%%%%%%#
#****************#
##################