12 18
##################
#R***************#
#**@******@**@***#
#******@*********#
#****************#
# o              #
##### #### ### #*#
#%%%# #%%###%# #:#
#   # #%%%%%%# # #
############## # #
#              dk#
#U################


R Carter
# Wall
% Rock
* Dirt
@ SingleRock
o Artifact
U Portal
: Bug
k Key
d Door
b Bomb