12 18
##################
#    %#          #
#    %# ***o**** #
#    %# ******** #
# R  %#          #
#%%% %# #### ### #
