12 18
##################
#                #
#        o o     #
#d##########%%%% #
#    b*****#     #
#    ******#     #
#    b*****#     #
# R  ******#     #
#    b*****#:    #
#    ******####  #
#    b*****% k#  #
################U#


R Carter
# Wall
% Rock
* Dirt
@ SingleRock
o Artifact
U Portal
: Bug
k Key
d Door
b Bomb