12 18
##################
#    @:%         #
#    # % # ***@**#
#    # % # ******#
#    # % #  o    #
#    # % #%%% %%U#
#    # % #%%%%%%%#
#    # % ####****#
#    # %    #****#
#    # %%%% #****#
# R  #    % #****#
##################


R Carter
# Wall
% Rock
* Dirt
@ SingleRock
o Artifact
U Portal
: Bug
k Key
d Door
b Bomb