12 18
##################
#                #
#  b         R   #
#  ##%%%%%%%%%%%%#
#  #             #
#  ###############
#     o  d       #
#%%#############U#
#  **************#
#  **************#
#  **********k***#
##################


R Carter
# Wall
% Rock
* Dirt
@ SingleRock
o Artifact
U Portal
: Bug
k Key
d Door
b Bomb