12 18
##################
#           o  o #
#                #
#     *          #
#      *     :   #
#                #
#     Ro         #
#              # #
#                #
#%%%%%%%%%%%U%%%%#
#****************#
##################